********************************
*..............................*
*%%%%%%%.......................*
************..............%....*
*....................***********
*..............................*
*..............................*
*....%.........*****...........*
*..............**.....%........*
*..............................*
*..............................*
*.........................%....*
*....%..**...............*******
*....*****..........************
*..............................*
*..............................*
*.............................%*
***..%.........**.............**
******.........**..........%%%**
******..................********
********......................**
********......................**
***********................%%%**
********************************